100000000000
000000000000
000000000000
000099999000
000000000002
